   ████████████████████████████
               █        █     █
█  ███████  ████  ██████████  █
█     █                 █  █  █
█  █  ████████████████  █  █  █
█  █              █     █     █
█  ███████  █  █  ████  ████  █
█     █  █  █  █     █        █
███████  ████████████████  ████
█           █     █           █
████  ██████████  ████  ███████
█     █  █     █     █        █
████  █  ████  █  █  █  █  ████
█                 █  █  █  █  █
███████  █  ███████  ████  █  █
█  █     █     █     █  █     █
█  █  ███████  █  █  █  █  █  █
█     █     █  █  █        █  █
████  ████  █  █  █  ████  █  █
█     █        █  █     █  █  
████████████████████████████  
