   ███████████████████████████████████████████
               █              █     █     █  █
█  █  ████  █  █  ████████████████  █  ████  █
█  █     █  █  █           █  █              █
███████  ████  ████  ████  █  █  ██████████  █
█  █  █     █     █     █  █  █     █     █  █
█  █  █  ███████  █  ███████  █  ███████  █  █
█        █           █  █                 █  █
██████████  █  ████  █  ████  ████  █  ████  █
█           █     █     █        █  █  █  █  █
█  ██████████  █  █  ███████  ████  ████  █  █
█  █        █  █  █     █        █     █     █
█  ███████  ███████  █  █  ████  ████  █  ████
█        █        █  █     █  █     █  █     █
█  █  ███████  ████  ███████  ████  █  █  ████
█  █        █  █     █        █  █  █  █     █
████  █  █  █  ████  █  █  ████  ██████████  █
█     █  █  █  █        █        █     █  █  █
█  █  ████  █  █  ███████████████████  █  █  █
█  █  █     █                          █     
███████████████████████████████████████████   
